,index,feature,infogain_50,reliefF_50,jmi_50,mrmr_50,chisquare_50,TOTAL
0,1,Ever addicted to any substance or behaviour_1,95,0,100,100,100,395
1,7,Townsend deprivation index at recruitment,100,0,100,100,74,374
2,221,rs139459337_2.rs10838524_2,28,100,6,100,73,307
3,37,rs228697_2.rs10462023_2,20,100,4,100,77,301
4,2,Age at recruitment,96,0,100,0,100,296
5,68,rs228697_2.rs10838524_2,15,100,8,98,75,296
6,229,rs139459337_2.rs2287161_2,18,100,1,100,60,279
7,174,rs1801260_0.rs139459337_2,27,100,3,100,47,277
8,0,sex_1,76,0,100,0,100,276
9,75,rs228697_2.rs2287161_0,12,100,2,100,59,273
10,112,rs10462020_2.rs10838524_0,19,100,0,100,46,265
11,231,rs139459337_2.rs2287161_1,19,100,0,100,42,261
12,101,rs10462020_2.rs17031614_1,8,100,0,100,50,258
13,129,rs10462023_2.rs1801260_2,19,100,0,100,37,256
14,145,rs10462023_1.rs139459337_2,15,100,1,100,36,252
15,113,rs10462020_2.rs10838524_2,16,100,0,100,34,250
16,197,rs17031614_0.rs139459337_2,16,100,1,96,36,249
17,93,rs10462020_2.rs1801260_1,14,100,0,100,35,249
18,223,rs139459337_2.rs10838524_1,18,100,0,100,29,247
19,92,rs10462020_1.rs1801260_2,11,100,0,100,35,246
20,53,rs228697_2.rs17031614_2,16,100,0,100,30,246
21,55,rs228697_2.rs17031614_1,23,100,0,100,22,245
22,76,rs228697_2.rs2287161_2,21,100,0,96,27,244
23,61,rs228697_1.rs139459337_2,15,100,0,100,28,243
24,59,rs228697_0.rs139459337_2,16,100,0,100,24,240
25,5,Average total household income before tax_3,39,0,100,0,100,239
26,143,rs10462023_0.rs139459337_2,15,100,1,100,22,238
27,176,rs1801260_1.rs139459337_2,16,100,0,100,22,238
28,120,rs10462020_2.rs2287161_0,22,100,0,100,13,235
29,168,rs1801260_2.rs17031614_2,10,87,0,100,35,232
30,67,rs228697_2.rs10838524_0,21,100,0,100,10,231
31,45,rs228697_2.rs1801260_2,18,100,0,100,11,229
32,107,rs10462020_2.rs139459337_1,22,100,0,100,6,228
33,199,rs17031614_2.rs139459337_2,14,100,0,100,13,227
34,86,rs10462020_2.rs10462023_1,16,100,0,94,17,227
35,84,rs10462020_2.rs10462023_2,21,100,0,100,4,225
36,177,rs1801260_2.rs139459337_1,17,100,0,100,8,225
37,121,rs10462020_2.rs2287161_2,14,100,0,100,10,224
38,99,rs10462020_2.rs17031614_2,13,100,0,100,10,223
39,4,Average total household income before tax_2,25,0,100,0,98,223
40,91,rs10462020_2.rs1801260_0,17,100,0,94,11,222
41,123,rs10462020_2.rs2287161_1,15,100,0,100,4,219
42,83,rs10462020_2.rs10462023_0,14,100,0,100,4,218
43,182,rs1801260_2.rs10838524_0,11,59,0,100,47,217
44,228,rs139459337_2.rs2287161_0,14,100,0,100,2,216
45,47,rs228697_2.rs1801260_1,22,98,5,4,86,215
46,115,rs10462020_2.rs10838524_1,13,100,0,100,2,215
47,170,rs1801260_2.rs17031614_1,18,80,0,100,15,213
48,62,rs228697_2.rs139459337_1,9,100,0,100,2,211
49,8,Chronotype_1,37,0,100,0,72,209
50,10,Chronotype_3,14,0,92,0,98,204
51,36,rs228697_2.rs10462023_0,19,93,7,12,69,200
52,190,rs1801260_2.rs2287161_0,15,77,0,100,7,199
53,105,rs10462020_0.rs139459337_2,20,100,4,0,68,192
54,71,rs228697_0.rs2287161_1,27,0,100,0,55,182
55,25,rs2287161_1,73,0,100,0,8,181
56,3,Average total household income before tax_1,22,0,95,0,59,176
57,66,rs228697_0.rs10838524_2,28,0,76,0,66,170
58,22,rs139459337_2,15,100,1,0,45,161
59,23,rs10838524_1,59,0,100,0,1,160
60,15,rs10462023_1,59,0,100,0,1,160
61,224,rs139459337_0.rs2287161_1,46,0,100,0,8,154
62,108,rs10462020_0.rs10838524_1,47,0,100,0,7,154
63,217,rs139459337_0.rs10838524_1,44,0,100,0,2,146
64,141,rs10462023_1.rs139459337_0,43,0,100,0,1,144
65,146,rs10462023_2.rs139459337_1,16,0,1,100,25,142
66,11,rs228697_1,30,0,100,0,12,142
67,98,rs10462020_2.rs17031614_0,15,100,0,19,7,141
68,209,rs17031614_0.rs2287161_1,36,0,95,0,9,140
69,26,rs2287161_2,27,0,100,0,13,140
70,116,rs10462020_0.rs2287161_1,35,0,100,0,4,139
71,32,rs228697_0.rs10462023_1,31,0,100,0,7,138
72,17,rs1801260_1,37,0,100,0,1,138
73,157,rs10462023_1.rs2287161_1,26,0,92,0,20,138
74,79,rs10462020_0.rs10462023_1,35,0,100,0,2,137
75,24,rs10838524_2,35,0,100,0,2,137
76,87,rs10462020_0.rs1801260_1,28,0,100,0,8,136
77,218,rs139459337_1.rs10838524_0,16,0,2,79,38,135
78,57,rs228697_1.rs139459337_0,23,0,100,0,12,135
79,104,rs10462020_1.rs139459337_1,11,0,0,100,22,133
80,63,rs228697_0.rs10838524_1,29,0,100,0,1,130
81,40,rs228697_0.rs1801260_1,21,0,96,0,12,129
82,227,rs139459337_0.rs2287161_2,22,0,98,0,7,127
83,220,rs139459337_0.rs10838524_2,26,0,97,0,2,125
84,201,rs17031614_0.rs10838524_1,24,0,95,0,5,124
85,28,rs228697_1.rs10462020_0,22,0,99,0,3,124
86,85,rs10462020_1.rs10462023_2,19,0,0,98,7,124
87,172,rs1801260_1.rs139459337_0,20,0,100,0,2,122
88,14,rs10462020_2,16,100,0,0,4,120
89,125,rs10462023_1.rs1801260_0,23,0,91,0,5,119
90,30,rs228697_0.rs10462020_2,14,100,0,0,4,118
91,6,Average total household income before tax_4,22,0,18,0,78,118
92,164,rs1801260_1.rs17031614_0,28,0,78,0,11,117
93,186,rs1801260_0.rs2287161_1,26,0,83,0,7,116
94,9,Chronotype_2,22,0,88,0,6,116
95,106,rs10462020_2.rs139459337_0,11,100,0,0,5,116
96,133,rs10462023_1.rs17031614_0,22,0,88,0,5,115
97,41,rs228697_1.rs1801260_0,19,0,53,0,41,113
98,111,rs10462020_0.rs10838524_2,24,0,87,0,1,112
99,119,rs10462020_0.rs2287161_2,24,0,79,0,7,110
100,149,rs10462023_1.rs10838524_1,22,0,67,0,18,107
101,69,rs228697_1.rs10838524_2,19,0,21,0,63,103
102,12,rs228697_2,20,0,10,0,72,102
103,31,rs228697_2.rs10462020_0,19,0,10,0,71,100
104,60,rs228697_2.rs139459337_0,26,0,6,0,68,100
105,232,rs10838524_0.rs2287161_1,22,0,10,0,61,93
106,178,rs1801260_0.rs10838524_1,25,0,50,0,8,83
107,161,rs10462023_1.rs2287161_2,12,0,26,0,43,81
108,234,rs10838524_1.rs2287161_1,22,0,55,0,1,78
109,20,rs17031614_2,23,0,36,0,14,73
110,198,rs17031614_2.rs139459337_0,17,0,29,0,27,73
111,74,rs228697_0.rs2287161_2,22,0,41,0,9,72
112,52,rs228697_2.rs17031614_0,22,0,1,0,47,70
113,135,rs10462023_0.rs17031614_2,13,0,9,0,45,67
114,235,rs10838524_0.rs2287161_2,16,0,5,0,45,66
115,137,rs10462023_2.rs17031614_2,16,0,1,23,25,65
116,80,rs10462020_1.rs10462023_0,13,0,8,0,43,64
117,175,rs1801260_2.rs139459337_0,19,0,2,0,42,63
118,19,rs17031614_1,21,0,37,0,2,60
119,166,rs1801260_0.rs17031614_2,13,0,7,0,39,59
120,128,rs10462023_2.rs1801260_0,22,0,6,0,30,58
121,18,rs1801260_2,17,0,2,0,39,58
122,49,rs228697_1.rs17031614_0,21,0,25,0,12,58
123,189,rs1801260_0.rs2287161_2,16,0,19,0,21,56
124,70,rs228697_2.rs10838524_1,17,2,1,0,34,54
125,152,rs10462023_2.rs10838524_2,18,0,4,0,32,54
126,151,rs10462023_2.rs10838524_0,19,0,0,22,13,54
127,181,rs1801260_0.rs10838524_2,14,0,24,0,15,53
128,81,rs10462020_1.rs10462023_1,14,0,0,0,36,50
129,200,rs17031614_2.rs139459337_1,13,0,0,26,9,48
130,192,rs1801260_1.rs2287161_2,22,0,8,0,18,48
131,191,rs1801260_2.rs2287161_2,17,0,0,2,28,47
132,195,rs17031614_1.rs139459337_0,22,0,14,0,11,47
133,180,rs1801260_1.rs10838524_1,17,0,24,0,6,47
134,78,rs228697_2.rs2287161_1,11,4,0,0,31,46
135,89,rs10462020_1.rs1801260_1,16,0,4,0,26,46
136,153,rs10462023_1.rs10838524_2,22,0,5,0,18,45
137,139,rs10462023_2.rs17031614_1,10,0,0,8,26,44
138,73,rs228697_1.rs2287161_1,14,0,14,0,15,43
139,156,rs10462023_1.rs2287161_0,19,0,1,0,23,43
140,46,rs228697_1.rs1801260_2,14,0,0,0,29,43
141,100,rs10462020_1.rs17031614_2,16,0,2,0,24,42
142,155,rs10462023_0.rs2287161_1,25,0,13,0,4,42
143,54,rs228697_1.rs17031614_2,16,0,0,0,26,42
144,193,rs1801260_2.rs2287161_1,19,0,0,0,23,42
145,208,rs17031614_2.rs10838524_1,16,0,5,0,21,42
146,136,rs10462023_2.rs17031614_0,15,0,2,0,24,41
147,148,rs10462023_1.rs10838524_0,11,0,3,0,27,41
148,225,rs139459337_1.rs2287161_0,20,0,0,14,7,41
149,188,rs1801260_1.rs2287161_1,22,0,13,0,5,40
150,43,rs228697_0.rs1801260_2,17,0,0,0,23,40
151,211,rs17031614_1.rs2287161_1,16,0,2,0,22,40
152,214,rs17031614_2.rs2287161_2,17,0,2,0,21,40
153,159,rs10462023_2.rs2287161_0,23,0,0,11,6,40
154,215,rs17031614_1.rs2287161_2,17,0,3,0,19,39
155,82,rs10462020_0.rs10462023_2,19,0,5,0,15,39
156,183,rs1801260_2.rs10838524_2,13,0,0,0,26,39
157,34,rs228697_1.rs10462023_1,30,0,3,0,6,39
158,29,rs228697_1.rs10462020_1,15,0,1,0,22,38
159,130,rs10462023_1.rs1801260_2,22,0,0,0,15,37
160,90,rs10462020_0.rs1801260_2,16,0,0,0,21,37
161,122,rs10462020_1.rs2287161_2,12,0,0,0,24,36
162,16,rs10462023_2,12,0,11,0,13,36
163,158,rs10462023_0.rs2287161_2,22,0,3,0,10,35
164,126,rs10462023_1.rs1801260_1,20,0,10,0,5,35
165,207,rs17031614_1.rs10838524_2,22,0,0,0,13,35
166,38,rs228697_1.rs10462023_2,24,0,0,0,11,35
167,147,rs10462023_0.rs10838524_1,17,0,11,0,7,35
168,216,rs17031614_2.rs2287161_1,21,0,2,0,11,34
169,187,rs1801260_1.rs2287161_0,20,0,2,0,12,34
170,97,rs10462020_0.rs17031614_2,23,0,3,0,8,34
171,230,rs139459337_1.rs2287161_2,18,0,0,0,16,34
172,226,rs139459337_1.rs2287161_1,20,0,0,0,13,33
173,239,rs10838524_2.rs2287161_1,25,0,4,0,4,33
174,132,rs10462023_0.rs17031614_1,16,0,1,0,16,33
175,95,rs10462020_1.rs17031614_0,20,0,1,0,12,33
176,64,rs228697_1.rs10838524_0,20,0,0,0,12,32
177,144,rs10462023_2.rs139459337_0,22,0,4,0,6,32
178,109,rs10462020_1.rs10838524_0,24,0,0,0,7,31
179,233,rs10838524_1.rs2287161_0,15,0,2,0,14,31
180,27,rs228697_0.rs10462020_1,20,0,2,0,9,31
181,56,rs228697_0.rs139459337_1,21,0,0,0,10,31
182,202,rs17031614_1.rs10838524_0,19,0,0,0,11,30
183,219,rs139459337_1.rs10838524_1,23,0,0,0,7,30
184,138,rs10462023_1.rs17031614_2,21,0,0,0,9,30
185,77,rs228697_1.rs2287161_2,20,0,1,0,8,29
186,204,rs17031614_0.rs10838524_2,14,0,13,0,2,29
187,103,rs10462020_1.rs139459337_0,21,0,3,0,5,29
188,102,rs10462020_0.rs139459337_1,21,0,1,0,7,29
189,118,rs10462020_1.rs2287161_1,18,0,0,0,11,29
190,13,rs10462020_1,17,0,10,0,2,29
191,110,rs10462020_1.rs10838524_1,19,0,0,0,10,29
192,222,rs139459337_1.rs10838524_2,14,0,0,0,14,28
193,162,rs10462023_2.rs2287161_1,17,0,0,0,11,28
194,194,rs17031614_0.rs139459337_1,19,0,0,0,9,28
195,44,rs228697_2.rs1801260_0,14,0,1,0,13,28
196,150,rs10462023_0.rs10838524_2,17,0,2,0,9,28
197,39,rs228697_2.rs10462023_1,16,0,0,0,11,27
198,33,rs228697_1.rs10462023_0,12,0,6,0,9,27
199,173,rs1801260_1.rs139459337_1,18,0,0,0,9,27
200,124,rs10462023_0.rs1801260_1,21,0,5,0,1,27
201,184,rs1801260_1.rs10838524_2,19,0,2,0,6,27
202,21,rs139459337_1,20,0,1,0,5,26
203,167,rs1801260_2.rs17031614_0,19,0,0,0,7,26
204,131,rs10462023_2.rs1801260_1,16,0,0,0,9,25
205,51,rs228697_0.rs17031614_2,20,0,1,0,4,25
206,58,rs228697_1.rs139459337_1,20,0,0,0,5,25
207,236,rs10838524_2.rs2287161_0,19,0,0,0,6,25
208,210,rs17031614_1.rs2287161_0,18,0,0,0,7,25
209,134,rs10462023_1.rs17031614_1,17,0,0,0,8,25
210,237,rs10838524_2.rs2287161_2,18,0,1,0,6,25
211,205,rs17031614_2.rs10838524_0,10,0,0,0,15,25
212,213,rs17031614_2.rs2287161_0,17,0,0,0,6,23
213,94,rs10462020_0.rs17031614_1,16,0,4,0,3,23
214,88,rs10462020_1.rs1801260_0,14,0,0,0,9,23
215,142,rs10462023_1.rs139459337_1,14,0,0,0,9,23
216,163,rs1801260_0.rs17031614_1,15,0,0,0,8,23
217,117,rs10462020_1.rs2287161_0,18,0,0,0,5,23
218,65,rs228697_1.rs10838524_1,18,0,3,0,2,23
219,35,rs228697_0.rs10462023_2,18,0,0,0,4,22
220,203,rs17031614_1.rs10838524_1,19,0,0,0,3,22
221,42,rs228697_1.rs1801260_1,18,0,1,0,3,22
222,154,rs10462023_2.rs10838524_1,14,0,0,0,8,22
223,171,rs1801260_0.rs139459337_1,13,0,0,0,9,22
224,96,rs10462020_1.rs17031614_1,14,0,0,0,7,21
225,206,rs17031614_2.rs10838524_2,9,0,0,0,12,21
226,196,rs17031614_1.rs139459337_1,13,0,0,4,4,21
227,238,rs10838524_1.rs2287161_2,15,0,1,0,5,21
228,179,rs1801260_1.rs10838524_0,15,0,0,0,6,21
229,165,rs1801260_1.rs17031614_1,11,0,0,0,10,21
230,212,rs17031614_0.rs2287161_2,14,0,4,0,3,21
231,127,rs10462023_0.rs1801260_2,8,0,0,0,13,21
232,140,rs10462023_0.rs139459337_1,15,0,0,0,5,20
233,160,rs10462023_2.rs2287161_2,17,0,0,0,2,19
234,185,rs1801260_2.rs10838524_1,13,0,0,0,6,19
235,50,rs228697_1.rs17031614_1,11,0,0,0,8,19
236,114,rs10462020_1.rs10838524_2,14,0,0,0,4,18
237,72,rs228697_1.rs2287161_0,13,0,0,0,5,18
238,48,rs228697_0.rs17031614_1,12,0,1,0,3,16
239,169,rs1801260_1.rs17031614_2,7,0,0,0,7,14
